9
10011110101111
00100000100000
10000010001001
10100110110011
10100000010010
10111011011111
00101010010100
10000000111111
00100100000111

