9
10011110101111
00100000100000
10000010001001
10100110110011
10100000010000
10111011010101
00101010010000
10000000110111
00100100000111

